NO assets/textures/snow.png
SO assets/textures/diamond.png
WE assets/textures/sand.png
EA assets/textures/grass.png

C 0,87,183
F 255,215,0

       11111111111111111111111111
       11000000000000000000000001
       11011000001110000001000001
       11001000000000000000000E01
111111111011000001110000000000001
100011100011000001110111111111111
11110000001111011100000010001
1111010011111011101010010001
110000110101011100000010001
1000100000000001100000010001
10000000000000001101010010001
1100000111010101111101111000111
11110111 1110101 101111010001
11111111 1111111 111111111111
